(no author) = "no author" <no_author@no_author>
bart = Bart Van Assche <bvanassche@acm.org>
bmeyer = Benjamin Meyer <ben@meyerhome.net>
carll = Carl Love <cel@us.ibm.com>
cartman =  Ismail Dönmez <ismail@pardus.org.tr>
cborntra = Christian Borntraeger <borntraeger@de.ibm.com>
cerion = Cerion Armour-Brown <cerion@valgrind.org>
daywalker = Dirk Mueller <daywalker@users.sourceforge.net>
de = Donna Robinson <donna@terpsichore.ws>
dejanj = Dejan Jevtic <dejan.jevtic@valgrind.org>
dirk = Dirk Mueller <daywalker@users.sourceforge.net>
fitzhardinge = Jeremy Fitzhardinge <jeremy@valgrind.org>
florian = Florian Krohm <florian@eich-krohm.de>
gobry = Frédéric Gobry <frederic.gobry@epfl.ch>
helio = Helio Chissini de Castro <helio@kde.org>
iraisr = Ivosh Raisr <ivosh@ivosh.net>
jf = Jon Fairbairn <jon.fairbairn@cl.cam.ac.uk>
jseward = Julian Seward <jseward@acm.org>
jsgf = Jeremy Fitzhardinge <jeremy@valgrind.org>
mjw = Mark Wielaard <mjw@redhat.com>
mueller = Dirk Mueller <dmuell@gmx.net>
nethercote = Nicholas Nethercote <n.nethercote@gmail.com>
njn25 = Nicholas Nethercote <njn25@cam.ac.uk>
njn = Nicholas Nethercote <njn@valgrind.org>
ossi = Oswald Buddenhagen <ossi@kde.org>
petarj = Petar Jovanovic <mips32r2@gmail.com>
paulus = Paul Mackerras <paulus@valgrind.org>
philippe = Philippe Waroquiers <philippe.waroquiers@skynet.be>
rhyskidd = Rhys Kidd <rhyskidd@gmail.com>
rjwalsh = Robert Walsh <rjwalsh@valgrind.org>
sewardj = Julian Seward <jseward@acm.org>
thughes = Tom Hughes <tom@compton.nu>
tom = Tom Hughes <tom@valgrind.org>
vince = Vince Weaver <vince@csl.cornell.edu>
weidendo = Josef Weidendorfer <Josef.Weidendorfer@gmx.de>
zliu = Zhi-Gang Liu <zliu@tilera.com>
